0 0 0 0 0 0 0 0 0 0 0 0 0 0 0 0
0 0 0 0 0 0 0 0 0 0 0 0 0 0 0 0
0 0 0 0 27 28 28 28 28 28 28 29 0 0 0 0
0 0 0 0 46 2 3 2 4 4 13 50 0 0 0 0
0 0 0 0 46 34 33 25 35 34 34 50 0 0 0 0
0 0 0 0 46 34 63 64 34 34 34 50 0 0 0 0
0 0 0 0 46 24 24 24 24 24 24 50 0 0 0 0
0 0 0 0 46 63 64 74 34 34 34 50 0 0 0 0
0 0 0 0 76 7 8 7 7 8 7 80 0 0 0 0
0 0 0 0 86 98 98 98 98 98 98 99 0 0 0 0
0 0 0 0 0 0 0 0 0 0 0 0 0 0 0 0
0 0 0 0 0 0 0 0 0 0 0 0 0 0 0 0