0 0 0 0 0 0 0 0 0 0 0 0 0 0 0 0
0 0 0 27 28 28 28 28 28 28 29 0 0 0 0 0
0 0 0 46 2 5 2 4 4 5 39 28 29 0 0 0
0 0 0 46 24 24 24 24 24 24 13 2 70 0 0 0
0 0 0 46 45 55 53 24 34 65 34 34 70 0 0 0
0 0 0 46 45 55 53 34 34 65 34 24 70 0 0 0
0 0 0 46 55 55 53 24 24 24 24 24 70 0 0 0
0 0 0 46 42 55 53 45 45 65 55 55 70 0 0 0
0 0 0 76 9 77 53 24 24 34 32 44 70 0 0 0
0 0 0 86 19 87 8 10 88 8 88 88 80 0 0 0
0 0 0 0 0 86 18 20 98 18 98 98 90 0 0 0
0 0 0 0 0 0 0 0 0 0 0 0 0 0 0 0