0 0 0 0 0 0 0 0 0 0 0 0 0 0 0 0
0 0 0 0 0 0 0 0 0 0 0 0 0 0 0 0
0 0 0 27 28 28 28 28 28 28 28 28 29 0 0 0
0 0 0 46 2 5 2 4 4 5 13 2 50 0 0 0
0 0 0 46 24 24 34 34 34 24 34 34 70 0 0 0
0 0 0 46 24 24 54 53 34 34 34 34 70 0 0 0
0 0 0 46 24 24 55 53 63 64 34 34 70 0 0 0
0 0 0 46 24 24 55 53 24 24 24 24 70 0 0 0
0 0 0 76 88 77 42 53 44 34 24 24 70 0 0 0
0 0 0 86 98 87 9 10 88 8 88 88 80 0 0 0
0 0 0 0 0 86 19 20 98 18 98 98 90 0 0 0
0 0 0 0 0 0 0 0 0 0 0 0 0 0 0 0