0 0 0 0 0 0 0 0 0 0 0 0 0 0 0 0
0 0 27 28 28 28 28 28 28 28 28 28 28 29 0 0
0 0 46 3 5 2 4 4 5 2 2 2 13 70 0 0
0 0 46 33 53 24 55 24 24 24 24 53 34 70 0 0 
0 0 46 34 53 24 53 24 24 24 24 53 34 70 0 0 
0 0 46 34 53 24 53 24 24 24 24 53 34 70 0 0
0 0 46 34 53 24 53 24 24 24 24 53 34 70 0 0 
0 0 46 34 55 24 53 24 24 24 24 34 34 70 0 0
0 0 46 34 53 24 53 24 24 24 24 34 34 70 0 0 
0 0 82 88 88 8 10 88 8 88 88 88 88 80 0 0
0 0 97 98 98 18 20 98 18 98 98 98 98 90 0 0
0 0 0 0 0 0 0 0 0 0 0 0 0 0 0 0